+   +---+---+---+---+---+---+---+---+---+---+---+---+---+---+---+---+---+---+---+---+---+---+---+---+---+---+---+---+---+
|               |                           |                       |               |       |                       |   |
+   +---+   +---+   +---+---+   +---+---+   +---+   +---+---+---+   +   +---+---+---+   +   +   +---+---+   +---+   +   +
|       |                   |   |       |   |       |                   |               |   |           |   |       |   |
+---+   +---+---+---+---+---+   +   +---+   +   +---+   +---+---+---+---+   +---+---+---+   +   +---+---+   +   +---+   +
|   |           |       |       |   |       |   |                   |       |           |       |           |   |       |
+   +---+---+   +   +   +   +---+   +   +---+   +   +---+---+---+---+   +---+   +   +---+---+---+   +---+---+   +   +   +
|           |   |   |       |                   |   |       |           |       |               |   |       |   |   |   |
+   +---+   +   +   +---+   +---+---+---+---+---+---+   +   +   +---+---+---+---+---+   +---+   +   +---+   +   +   +   +
|   |   |       |       |   |                           |   |       |                   |       |       |   |       |   |
+   +   +---+---+---+   +---+   +---+---+---+---+---+---+   +---+   +   +---+---+---+---+   +---+---+   +   +---+---+   +
|       |           |       |   |       |               |       |       |   |           |   |           |               |
+---+---+   +---+   +---+   +   +   +   +   +---+---+   +   +---+---+---+   +   +---+   +   +   +---+   +---+---+   +---+
|           |               |   |   |   |   |   |       |                   |   |   |       |   |       |       |       |
+   +---+---+   +---+---+   +   +   +---+   +   +   +   +---+---+   +---+---+   +   +---+---+   +---+---+   +   +---+---+
|           |   |       |   |   |               |   |   |       |   |           |           |   |           |           |
+   +---+   +---+   +   +---+   +   +---+---+---+   +   +   +---+   +   +---+---+   +   +   +   +   +   +---+---+   +   +
|   |   |           |           |   |       |       |   |       |   |   |       |   |   |   |       |   |       |   |   |
+   +   +---+---+---+---+---+---+   +   +   +   +---+   +---+   +   +   +   +   +   +   +---+---+   +---+   +   +---+   +
|   |                       |           |   |   |   |           |       |   |   |   |   |       |   |       |   |       |
+   +   +---+   +---+---+   +   +---+---+---+   +   +   +---+---+   +---+   +   +---+   +   +   +---+   +---+   +   +---+
|   |   |   |           |   |   |       |       |   |   |       |           |       |   |   |       |   |       |       |
+   +   +   +---+---+   +   +---+   +   +   +   +   +   +   +   +---+---+---+---+   +   +   +---+   +   +---+   +---+   +
|   |           |       |           |   |   |   |       |   |   |           |       |   |   |   |   |       |       |   |
+   +---+---+---+   +---+---+---+---+   +   +---+   +---+   +   +   +---+   +   +---+   +   +   +   +---+   +---+   +   +
|   |               |               |   |       |       |   |       |       |   |       |   |       |       |   |       |
+   +   +---+---+---+   +---+---+   +   +---+   +---+---+   +---+---+   +---+   +   +---+   +   +---+   +---+   +---+   +
|   |   |   |       |   |       |       |       |           |           |   |       |       |           |       |       |
+   +   +   +   +   +   +   +   +---+---+   +   +   +---+---+   +---+---+   +   +   +   +---+   +---+---+   +   +   +---+
|   |   |   |   |       |   |           |   |   |   |       |   |               |   |   |       |       |   |   |   |   |
+   +   +   +   +---+---+---+---+   +   +   +   +   +---+   +   +---+---+---+   +---+   +---+---+   +   +---+   +   +   +
|       |   |   |                   |   |   |   |       |   |   |           |   |       |           |       |   |   |   |
+---+---+   +   +   +   +---+---+---+   +   +   +---+   +   +   +   +---+   +---+   +   +   +---+---+---+   +   +   +   +
|               |   |       |       |   |   |   |   |   |   |       |               |   |   |       |       |   |   |   |
+   +---+---+---+   +---+   +   +   +   +   +   +   +   +   +---+   +---+---+---+---+   +   +   +---+   +---+   +   +   +
|           |   |   |       |   |   |   |   |   |   |   |           |               |   |       |       |   |       |   |
+---+---+   +   +   +   +---+   +---+   +   +   +   +   +   +---+---+   +---+---+   +---+---+   +   +---+   +   +---+   +
|       |   |       |       |               |       |   |           |   |       |               |   |           |       |
+   +   +   +---+   +---+   +   +---+---+---+---+---+   +---+---+---+   +   +   +---+---+---+---+   +   +---+---+---+   +
|   |   |       |       |   |   |       |               |               |   |           |           |   |               |
+   +   +---+   +---+---+   +   +---+   +   +---+---+---+   +---+---+---+---+---+---+   +   +---+---+   +   +---+---+---+
|   |       |       |       |       |   |               |       |                   |   |       |           |           |
+   +---+   +---+   +   +---+---+   +   +---+---+---+   +---+   +---+   +---+---+   +   +---+   +---+---+---+   +---+   +
|   |   |       |       |       |       |           |                   |               |   |                   |       |
+   +   +---+   +---+---+---+   +---+   +   +---+   +   +---+---+---+---+---+---+---+   +   +---+---+---+---+---+   +   +
|       |   |   |                   |   |   |       |   |       |       |           |       |       |       |       |   |
+---+   +   +   +   +   +---+---+   +   +---+   +   +---+   +   +   +   +   +---+   +---+   +   +---+   +   +   +---+   +
|       |   |   |   |       |       |           |   |       |       |       |   |       |       |       |   |       |   |
+   +---+   +   +---+---+   +---+---+---+---+---+   +   +---+---+---+---+---+   +---+   +---+   +   +---+   +   +   +   +
|       |   |   |       |       |       |       |   |           |       |       |       |       |       |   |   |   |   |
+---+   +   +---+   +   +---+   +   +   +   +   +   +---+---+   +   +   +   +   +   +---+---+---+---+   +   +---+   +   +
|       |           |       |       |       |       |       |   |   |       |   |   |               |   |           |   |
+   +---+   +---+---+---+   +   +---+---+---+---+---+   +   +   +   +---+---+   +   +   +---+---+   +   +---+---+---+   +
|   |       |           |   |       |       |       |   |       |           |   |       |       |   |   |           |   |
+   +   +---+   +---+   +   +---+---+   +   +   +   +   +---+---+   +---+   +---+---+---+   +---+   +   +   +   +   +   +
|   |       |   |       |           |   |       |       |       |       |           |       |       |   |   |   |   |   |
+   +---+   +   +---+---+---+---+   +   +---+---+---+---+   +---+---+   +---+   +---+   +   +   +---+   +   +   +---+   +
|           |   |               |       |       |           |       |   |   |           |       |       |   |           |
+---+---+---+   +   +---+   +---+---+---+   +   +   +---+   +   +   +   +   +---+---+---+---+---+---+   +   +---+---+---+
|                       |                   |           |       |                                       |                
+---+---+---+---+---+---+---+---+---+---+---+---+---+---+---+---+---+---+---+---+---+---+---+---+---+---+---+---+---+---+

